id,__name,__status,__amount,_floor_id,_room_detail_id
1,H0101,1,1,1,1
2,H0102,0,1,1,3
3,H0203,0,1,2,3
4,H0204,0,1,2,3
5,H0305,1,1,3,1
6,I0106,0,1,4,1
7,I0207,1,1,5,1
8,I0308,1,1,6,2
9,K0109,1,1,7,3
10,K0201,0,1,8,4
